48 28
1 1 1 1 1 1 1 1 1 1 1 1 1 1 1 1 1 1 1 1 1 1 1 1 1 1 1 1 1 1 1 1 1 1 1 1 1 1 1 1 1 1 1 1 1 1 1 1
1 5 3 0 0 0 0 0 0 0 0 0 0 0 0 0 0 0 0 0 0 0 0 0 0 0 0 0 0 0 0 0 0 0 0 0 0 0 0 0 0 0 0 0 0 3 5 1
1 3 0 0 0 0 0 0 0 0 0 0 0 0 0 0 0 0 0 0 0 0 0 0 0 0 0 0 0 0 0 0 0 0 0 0 0 0 0 0 0 0 0 0 0 0 3 1
1 0 0 1 0 0 0 0 0 0 0 0 0 0 0 0 0 0 0 0 0 5 5 5 5 5 5 0 0 0 0 0 0 0 0 0 0 0 0 0 0 0 0 0 1 0 0 1
1 0 0 0 0 0 0 0 0 1 1 1 1 1 1 1 1 1 1 1 1 1 1 3 3 1 1 1 1 1 1 1 1 1 1 1 1 1 1 0 0 0 0 0 0 0 0 1
1 0 0 0 0 0 0 0 0 0 0 0 0 0 0 0 0 0 0 0 0 5 3 0 0 3 5 0 0 0 0 0 0 0 0 0 0 0 0 0 0 0 0 0 0 0 0 1
1 0 0 3 3 3 0 0 0 0 0 0 0 0 0 0 0 0 0 0 0 0 0 0 0 0 0 0 0 0 0 0 0 0 0 0 0 0 0 0 0 0 3 3 3 0 0 1
1 0 0 3 5 3 0 0 0 0 0 0 0 0 0 0 0 0 0 0 0 0 0 0 0 0 0 0 0 0 0 0 0 0 0 0 0 0 0 0 0 0 3 5 3 0 0 1
1 0 0 3 5 3 0 0 0 3 3 3 3 3 3 3 3 3 3 0 0 0 0 0 0 0 0 0 0 3 3 3 3 3 3 3 3 3 3 0 0 0 3 5 3 0 0 1
1 0 0 3 5 3 0 0 0 3 3 3 3 3 3 3 3 3 3 0 0 0 0 0 0 0 0 0 0 3 3 3 3 3 3 3 3 3 3 0 0 0 3 5 3 0 0 1
1 0 0 3 5 3 0 0 0 3 3 3 3 3 3 3 3 3 3 0 0 0 0 0 0 0 0 0 0 3 3 3 3 3 3 3 3 3 3 0 0 0 3 5 3 0 0 1
1 0 0 3 3 3 0 0 0 0 0 0 0 0 0 0 0 0 0 0 0 0 0 3 3 0 0 0 0 0 0 0 0 0 0 0 0 0 0 0 0 0 3 3 3 0 0 1
1 0 0 0 0 0 0 0 0 0 0 0 0 0 0 0 0 0 0 0 0 0 0 3 3 0 0 0 0 0 0 0 0 0 0 0 0 0 0 0 0 0 0 0 0 0 0 1
1 2 0 0 0 0 0 0 0 0 0 0 0 0 0 0 5 5 0 0 0 0 0 3 3 0 0 0 0 0 5 5 0 0 0 0 0 0 0 0 0 0 0 0 0 2 0 1
1 0 0 0 0 0 0 1 1 1 1 0 0 0 0 0 5 5 0 0 0 0 0 3 3 0 0 0 0 0 5 5 0 0 0 0 0 1 1 1 1 0 0 0 0 0 0 1
1 0 0 0 0 0 0 1 5 5 1 0 0 0 0 0 0 1 0 0 0 0 0 3 3 0 0 0 0 0 1 0 0 0 0 0 0 1 5 5 1 0 0 0 0 0 0 1
1 0 0 0 0 0 0 1 5 5 1 0 0 0 0 0 0 1 0 0 0 0 0 3 3 0 0 0 0 0 1 0 0 0 0 0 0 1 5 5 1 0 0 0 0 0 0 1
1 0 0 0 0 0 0 1 0 0 1 0 0 0 0 0 0 1 0 0 0 0 0 3 3 0 0 0 0 0 1 0 0 0 0 0 0 1 0 0 1 0 0 0 0 0 0 1
1 0 0 0 0 0 0 1 0 0 1 0 0 0 0 0 0 1 0 0 0 0 0 3 3 0 0 0 0 0 1 0 0 0 0 0 0 1 0 0 1 0 0 0 0 0 0 1
1 0 0 0 0 0 0 1 0 0 1 0 0 0 0 0 0 1 0 0 3 0 0 3 3 0 0 3 0 0 1 0 0 0 0 0 0 1 0 0 1 0 0 0 0 0 0 1
1 0 0 0 0 0 0 1 0 0 1 0 0 0 0 0 0 1 0 0 0 0 0 3 3 0 0 0 0 0 1 0 0 0 0 0 0 1 0 0 1 0 0 0 0 0 0 1
1 0 0 0 0 0 0 1 0 0 1 0 0 0 0 0 0 1 0 0 0 0 0 3 3 0 0 0 0 0 1 0 0 0 0 0 0 1 0 0 1 0 0 0 0 0 0 1
1 3 0 0 0 0 0 1 0 0 1 0 0 0 0 0 0 1 0 0 0 0 0 3 3 0 0 0 0 0 1 0 0 0 0 0 0 1 0 0 1 0 0 0 0 0 3 1
1 3 3 0 0 0 0 1 0 0 1 0 0 0 0 0 0 1 0 0 0 0 5 3 3 5 0 0 0 0 1 0 0 0 0 0 0 1 0 0 1 0 0 0 0 3 3 1
1 3 3 3 0 0 0 1 0 0 1 0 0 0 0 0 0 1 0 0 0 0 5 3 3 5 0 0 0 0 1 0 0 0 0 0 0 1 0 0 1 0 0 0 3 3 3 1
1 3 3 3 3 0 0 0 0 0 0 0 0 0 0 0 0 0 0 0 0 0 5 3 3 5 0 0 0 0 0 0 0 0 0 0 0 0 0 0 0 0 0 3 3 3 3 1
1 5 3 3 3 3 0 0 0 0 0 0 0 0 0 0 0 0 0 0 0 0 5 3 3 5 0 0 0 0 0 0 0 0 0 0 0 0 0 0 0 0 3 3 3 3 5 1
1 1 1 1 1 1 1 1 1 1 1 1 1 1 1 1 1 1 1 1 1 1 1 1 1 1 1 1 1 1 1 1 1 1 1 1 1 1 1 1 1 1 1 1 1 1 1 1