8 8
1 1 1 1 1 1 1 1
1 2 0 0 0 1 1 1
1 0 0 0 1 2 0 1
1 0 0 0 0 0 0 1
1 0 0 5 5 1 1 1
1 0 0 0 0 5 51 1
1 0 0 0 0 5 5 1
1 1 1 1 1 1 1 1
