11 12
1 1 1 1 1 1 1 1 1 1 1
1 2 0 3 5 1 0 0 0 0 0
1 0 0 3 5 1 0 0 0 0 0
1 0 0 3 5 1 0 0 0 0 0
1 0 0 5 3 1 0 0 0 0 0
1 0 0 5 3 1 0 0 0 0 0
1 0 0 5 3 1 0 0 0 0 0
1 0 0 5 5 1 0 0 0 0 0
1 0 0 5 5 1 0 0 0 0 0
1 0 0 0 0 1 0 0 0 0 0
1 0 0 0 0 1 0 0 0 2 0
1 0 0 0 0 1 0 0 0 0 0
